20,20,.,o,x,*
********************
*..................*
*..................*
*..................*
*............x.....*
*..................*
*..................*
*..................*
*..................*
*..................*
*...o..............*
*..................*
*..................*
*..................*
*..................*
*..................*
*..................*
*..................*
********************

