20,20,.,o,x,*
********************
*..............*.o.*
*..............*...*
*..............*...*
*..............*...*
*............***...*
*............*.....*
*............*.*****
*..........***.*...*
*..........*...*...*
*..........*..**...*
*......*****..*....*
*......*......*....*
*......*...****....*
********...*.......*
*..........*.......*
*..x..******.......*
*.....*............*
********************

